00000000
..0..0..
00000000
...00...
00000000